s;tetrofile=/res/tetros.txt;blockSize=40
t;x=5;y=4;r=1;t=1
w;001000000000
w;001100000000
w;001010000000
w;001001000000
w;001010000000
w;001100000000
w;001000000000
w;001000000000
