b;tetrofile=/res/tetros.txt
p;x=7;y=7;



m;type=0;a=99
m;type=1;a=99
m;type=2;a=99
m;type=3;a=99
m;type=4;a=99
m;type=5;a=99
m;type=6;a=99
t;x=7;y=6;r=0;t=1
t;x=12;y=7;r=0;t=3
t;x=8;y=8;r=0;t=0
t;x=15;y=5;r=0;t=3
t;x=18;y=6;r=0;t=0
t;x=21;y=5;r=2;t=1
t;x=22;y=7;r=0;t=1
t;x=14;y=8;r=2;t=1



w;11111111111111100000000000000000000000000000000000000
w;10000000000000100000000000000000000000000000000000000
w;10000000000000100000000000000000000000000000000000000
w;10000000000000100000000000000000000000000000000000000
w;10000000000000111110011111000000000000000000000000000
w;10000000000000110011110001100000000000000000000000000
w;10000000000000100000000001100000000000000000000000000
w;10000000000000000011110000000000000000000000000000000
w;10000000000000100010010001110000000000000000000000000
w;10000000000000111010011111010000000000000000000000000
w;10000000000000101110000000110000000000000000000000000
w;10000000000000100000000000100000000000000000000000000
w;10000000000000100000000000100000000000000000000000000
w;10000000000000100000000000100000000000000000000000000
w;11111111111111100000000000000000000000000000000000000
w;00000000000000000000000000000000000000000000000000000





