b;tetrofile=/res/tetros.txt
p;x=7;y=7;



m;type=0;a=99
m;type=1;a=99
m;type=2;a=99
m;type=3;a=99
m;type=4;a=99
m;type=5;a=99
m;type=6;a=99
t;x=7;y=6;r=0;t=1
t;x=12;y=7;r=0;t=3
t;x=8;y=8;r=0;t=0
t;x=15;y=5;r=0;t=3
t;x=18;y=6;r=0;t=0
t;x=21;y=5;r=2;t=1
t;x=22;y=7;r=0;t=1
t;x=14;y=8;r=2;t=1



w;1111111111111110000000000000000000000000000000000000010000000000000000000000000000000000000000000000000000
w;1000000000000010000000000000000000000000000000000000010000000000000000000000000000000000000000000000000000
w;1000000000000010000000000000000000000000000000000000010000000000000000000000000000000000000000000000000000
w;1000000000000010000000000000000000000000000000000000010000000000000000000000000000000000000000000000000000
w;1000000000000011111001111100000000000000000000000000010000000000000000000000000000000000000000000000000000
w;1000000000000011001111000111111100000000000000000000010000000000000000000000000000000000000000000000000000
w;1000000000000010000000000110000100000000000000000000010000000000000000000000000000000000000000000000000000
w;1000000000000000001111000000100100000000000000000000010000000000000000000000000000000000000000000000000000
w;1000000000000010001001000111100100000000000000000000010000000000000000000000000000000000000000000000000000
w;1000000000000011101001111101000100000000000000000000010000000000000000000000000000000000000000000000000000
w;1000000000000010111000000011000100000000000000000000010000000000000000000000000000000000000000000000000000
w;1000000000000010000000000010000100000000000000000000010000000000000000000000000000000000000000000000000000
w;1000000000000010000000000010000100000000000000000000010000000000000000000000000000000000000000000000000000
w;1000000000000010000000000011000101110000000000000000010000000000000000000000000000000000000000000000000000
w;1111111111111110000000000001100111010000000000000000010000000000000000000000000000000000000000000000000000
w;0000000000000000000000000000110100010000000000000000010000000000000000000000000000000000000000000000000000
w;1000000000000000000000000000000000000000000000000000010000000000000000000000000000000000000000000000000000
w;1000000000000000000000000000000000000000000000000000010000000000000000000000000000000000000000000000000000
w;1000000000000000000000000000000000000000000000000000010000000000000000000000000000000000000000000000000000
w;1000000000000000000000000000000000000000000000000000010000000000000000000000000000000000000000000000000000
w;1000000000000000000000000000000000000000000000000000010000000000000000000000000000000000000000000000000000
w;1000000000000000000000000000000000000000000000000000010000000000000000000000000000000000000000000000000000




