i;tetrofile=/res/tetros.txt
p;x=4;y=2

w;000000000000
w;001000101000
w;011000001100
w;001101000100
w;000111111110
w;000001010100
w;000001000100
w;000111101100
w;000100110000
w;0000001000!0
w;000000000000