b;tetrofile=/res/tetros.txt
p;x=7;y=7;



m;type=0;a=99
m;type=1;a=99
m;type=2;a=99
m;type=3;a=99
m;type=4;a=99
m;type=5;a=99
m;type=6;a=99

//t;x=8;y=8;r=0;t=0
//t;x=15;y=6;r=0;t=2
//t;x=22;y=6;r=0;t=4
//t;x=27;y=6;r=2;t=1
//t;x=29;y=10;r=3;t=4
//t;x=29;y=14;r=0;t=6
//t;x=31;y=16;r=0;t=0


t;x=7;y=6;r=0;t=1
t;x=12;y=7;r=0;t=3
t;x=15;y=5;r=0;t=3
t;x=18;y=6;r=0;t=0
t;x=21;y=5;r=2;t=1
t;x=22;y=7;r=0;t=1
t;x=14;y=8;r=2;t=1
t;x=25;y=6;r=0;t=2
t;x=29;y=7;r=3;t=3
t;x=28;y=9;r=0;t=6
t;x=27;y=11;r=0;t=6
t;x=28;y=12;r=0;t=2
t;x=29;y=16;r=0;t=4
t;x=32;y=14;r=0;t=2
t;x=33;y=17;r=0;t=6
t;x=33;y=21;r=1;t=1
t;x=33;y=24;r=0;t=2
t;x=36;y=18;r=0;t=6
t;x=38;y=18;r=0;t=6
t;x=40;y=18;r=3;t=5
t;x=36;y=20;r=0;t=0





w;11111111111111100000000000000000000000000000000000000
w;10000000000000100000000000000000000000000000000000000
w;10000000000000100000000000000000000000000000000000000
w;10000000000000100000000000000000000000000000000000000
w;10000000000000111110011111000000000000000000000000000
w;10000000000000110011110001111111000000000000000000000
w;10000000000000100000000001100001000000000000000000000
w;10000000000000000011110000001001000000000000000000000
w;10000000000000100010010001111001000000000000000000000
w;10000000000000111010011111001101000000000000000000000
w;10000000000000101110000000111101000000000000000000000
w;10000000000000100000000000100001000000000000000000000
w;10000000000000100000000000100001000000000000000000000
w;10000000000000100000000000110001011100000000000000000
w;11111111111111100000000000011001110100000000000000000
w;00000000000000000000000000001001000100000000000000000
w;10000000000000000000000000001000000100000000000000000
w;10000000000000000000000000001100100111111100000000000
w;10000000000000000000000000000111100100000100000000000
w;10000000000000000000000000000000110100000000000000000
w;10000000000000000000000000000000010000000100000000000
w;10000000000000000000000000000000010111111100000000000
w;10000000000000000000000000000000010100000000000000000
w;10000000000000000000000000000000110110000000000000000
w;10000000000000000000000000000000100010000000000000000
w;10000000000000000000000000000000100010000000000000000
w;10000000000000000000000000000000111110000000000000000
w;10000000000000000000000000000000000000000000000000000
###
Tl;x=7;y=7;amount=99,99,99,99,99,99,99
Tl;x=41;y=19;amount=99,99,99,99,99,99,99





