i;tetrofile=/res/tetros.txt
p;x=19;y=5
t;x=17;y=4;r=0;t=0
t;x=15;y=6;r=0;t=0
w;11111111111111111111111111111
w;00110000000000000000000010001
w;00101000000000000000001000001
w;00100100000000000000000010001
w;00001000000000000000001000001
w;00110000000000000000000010001
w;00100000000000000000001000001
w;001000000000!0000000000010001
w;00100000000000000000001000001
w;00100000000000010000000010001
w;00000000000000000100000000001
w;00100000000000000001000000001
w;00100000000000000000000000001
w;00100000000000000001000000001
w;00100000000000000000000000001
w;00100000000000000001000000001
###
