b;tetrofile=/res/tetros.txt
p;x=7;y=7


m;type=0;a=99
m;type=1;a=99
m;type=2;a=99
m;type=3;a=99
m;type=4;a=99
m;type=5;a=99
m;type=6;a=99

//t;x=8;y=8;r=0;t=0
//t;x=15;y=6;r=0;t=2
//t;x=22;y=6;r=0;t=4
//t;x=27;y=6;r=2;t=1
//t;x=29;y=10;r=3;t=4
//t;x=29;y=14;r=0;t=6
//t;x=31;y=16;r=0;t=0


t;x=7;y=6;r=0;t=1
t;x=12;y=7;r=0;t=3
t;x=15;y=5;r=0;t=3
t;x=18;y=6;r=0;t=0
t;x=21;y=5;r=2;t=1
t;x=22;y=7;r=0;t=1
t;x=14;y=8;r=2;t=1
t;x=25;y=6;r=0;t=2
t;x=29;y=7;r=3;t=3
t;x=28;y=9;r=0;t=6
t;x=27;y=11;r=0;t=6
t;x=28;y=12;r=0;t=2
t;x=29;y=16;r=0;t=4
t;x=32;y=14;r=0;t=2
t;x=33;y=17;r=0;t=6
t;x=33;y=21;r=1;t=1
t;x=33;y=24;r=0;t=2
t;x=36;y=18;r=0;t=6
t;x=38;y=18;r=0;t=6
t;x=40;y=18;r=3;t=5
t;x=36;y=20;r=0;t=0
t;x=48;y=24;r=2;t=1
t;x=51;y=26;r=3;t=5
t;x=63;y=31;r=3;t=5
t;x=69;y=43;r=0;t=1




w;111111111111111000000000000000000000000000000000000000000000000000000000000
w;100000000000001000000000000000000000000000000000000000000000000000000000000
w;100000000000001000000000000000000000000000000000000000000000000000000000000
w;100000000000001000000000000000000000000000000000000000000000000000000000000
w;100000000000001111100111110000000000000000000000000000000000000000000000000
w;100000000000001100111100011111110000000000000000000000000000000000000000000
w;100000000000001000000000011000010000000000000000000000000000000000000000000
w;1000!0000000000000111100000010010000000000000000000000000000000000000000000
w;100000000000001000100100011110010000000000000000000000000000000000000000000
w;100000000000001110100111110011010000000000000000000000000000000000000000000
w;100000000000001011100000001111010000000000000000000000000000000000000000000
w;100000000000001000000000001000010000000000000000000000000000000000000000000
w;100000000000001000000000001000010000000000000000000000000000000000000000000
w;100000000000001000000000001100010111000000000000000000000000000000000000000
w;111111111111111000000000000110011101000000000000000000000000000000000000000
w;000000000000000000000000000010010001000000000000000000000000000000000000000
w;000000000000000000000000000010000001000000011111100000000000000000000000000
w;000000000000000000000000000011001001111111010000100000000000000000000000000
w;000000000000000000000000000001111001000001110100100000000000000000000000000
w;00000000000000000000000000000000110100000S000100111100000000000000000000000
w;000000000000000000000000000000000100000001101110000100000000000000000000000
w;000000000000000000000000000000000101111111000011101100000000000000000000000
w;000000000000000000000000000000000101000001111000001000000000000000000000000
w;000000000000000000000000000000001101100000001110101110111110000000000000000
w;000000000000000000000000000000001000100000000010100010100010111000000000000
w;000000000000000000000000000000001000100000000011111S11101011101000000000000
w;000000000000000000000000000000001111100000000000001010001001101110000000000
w;000000000000000000000000000000000000000000000000001000011100000010000000000
w;000000000000000000000000000000000000000000000000001011000111111010000000000
w;000000000000000000000000000000000000000000000000001111110100011010000000000
w;000000000000000000000000000000000000000000000000000000010001001011111111000
w;000000000000000000000000000000000000000000000000000000010101011011000001000
w;0000000000000000000000000000000000000000000000000000000111110110S0010001000
w;000000000000000000000000000000000000000000000000000000000100000010100111000
w;000000000000000000000000000000000000000000000000000000000111111111101100000
w;000000000000000000000000000000000000000000000000000000000000000001001000000
w;000000000000000000000000000000000000000000000000000000000000000001101111000
w;000000000000000000000000000000000000000000000000000000000000000000100001000
w;000000000000000000000000000000000000000000000000000000000000000000111011000
w;000000000000000000000000000000000000000000000000000000000000000000001010000
w;000000000000000000000000000000000000000000000000000000000000000000001010000
w;000000000000000000000000000000000000000000000000000000000000000000001010000
w;000000000000000000000000000000000000000000000000000000000000000000001011110
w;000000000000000000000000000000000000000000000000000000000000000000001010010
w;00000000000000000000000000000000000000000000000000000000000000000000100!010
w;000000000000000000000000000000000000000000000000000000000000000000001111110




###
Tl;x=7;y=7;amount=15,15,15,15,15,15,15;
Tl;x=41;y=19;amount=2,3,1,1,1,2,1;
Tl;x=51;y=25;amount=2,2,2,2,2,1,1;
Tl;x=64;y=32;amount=3,1,0,1,1,1,1;






