b;tetrofile=/res/tetros.txt
p;x=13;y=6
t;x=5;y=4;r=0;t=0
t;x=10;y=3;r=0;t=2
t;x=12;y=2;r=2;t=1
t;x=12;y=6;r=3;t=2
t;x=14;y=5;r=0;t=5
t;x=14;y=7;r=2;t=3



w;00000000000000000000000000000
w;00000000000000000000000000000
w;000000000000c0000000000000000
w;00000000000000000000000000000
w;0000a0000b00000d0000000000000
w;00000000000000000000000000000
w;0000000000000f000e00000000000
w;00000000000000000000000000000
w;00000000000000g00000000000000
w;00000000000000000000000000000
w;00000000000000000000000000000
w;00000000000000000000000000000
w;0000000000000h000000000000000
###



