b;tetrofile=/res/tetros.txt
p;x=2;y=9


w;000000000000000000000
w;000000000000000000000
w;000000000000000000000
w;0000000h0000000000000
w;00000000000g000000000
w;000000000000000000000
w;00000000000000f000000
w;000000000000000000000
w;000000000000000e00000
w;00a000000c00000000000
w;000000b00000d00000000
w;000000000000000000000
w;000000000000000000000
###

//l0


Td;x=1;y=8;xo=0;yo=-8;name=block0u;