i;tetrofile=/res/tetros.txt;blockSize=45
p;x=4;y=4
t;x=5;y=4;r=0;t=0

w;00000000000000000000000000000
w;00000000000000000000000000000
w;000000000000c0000000000000000
w;00000000000000000000000000000
w;0000a0000b00000d0000000000000
w;00000000000000000000000000000
w;0000000000000f000e00000000000
w;00000000000000000000000000000
w;00000000000000g00000000000000
w;00000000000000000000000000000
w;00000000000000000000000000000
w;00000000000000000000000000000
w;0000000000000h000000000000000