p;x=12;y=9
t;x=12;y=9;r=2;t=1

w;00000000000000000000000000000000000000000
w;00000000000000000000000000000000000000000
w;00000000000000000000000000000000000000000
w;00000000000000000h00000000000000000000000
w;000000000000000000000g0000000000000000000
w;00000000000000000000000000000000000000000
w;000000000000000000000000f0000000000000000
w;00000000000000000000000000000000000000000
w;0000000000000000000000000e000000000000000
w;000000000000a000000c000000000000000000000
w;0000000000000000b00000d000000000000000000
w;00000000000000000000000000000000000000000
w;00000000000000000000000000000000000000000
w;00000000000000000000000000000000000000000
w;00000000000000000000000000000000000000000
w;00000000000000000000000000000000000000000
w;00000000000000000000000000000000000000000
w;00000000000000000000000000000000000000000
w;00000000000000000000000000000000000000000
w;00000000000000000000000000000000000000000
w;00000000000000000000000000000000000000000
w;00000000000000000000000000000000000000000
w;00000000000000000000000000000000000000000
###
Td;x=16;y=3;xo=0;yo=-90;name=dekoDoor1;

//l0
Td;x=11;y=8;xo=0;yo=-8;name=block0u;

//l1
Td;x=13;y=8;xo=0;yo=0;name=ventilator;
Td;x=14;y=8;xo=0;yo=0;name=ventilator;
Td;x=15;y=8;xo=0;yo=0;name=ventilator;
Td;x=12;y=10;xo=0;yo=-8;name=block0w;
Td;x=11;y=10;xo=0;yo=-55;name=dekoTurm1;
c;74319
